$$$$$$$$$$$$$$$$$$$$
$$$$$$$$$$$$$$$$$$$$
..$$$$$$$$$$$$$$$$$$
$....$$$$$$$$$$$$$$$
$$$$..$$$$$$$$$$$$$$
$$$$$..$$....$$$$$$$
$$$$$$....$$..$$$$$$
$$$$$$$$$$$.$..$$$$$
$$$$$$$$$........$$$
$$$$$$$$.......$$.$$
$$$$$$$....$.......$
$$$$$$$..$$........$
$$$$$$$.$$$.$......$
$$$$$$$$.$$$......$$
$$$$$$$$$$.......$$$
$$$$$$$$$$$....$$$$$
$$$$$$.........$$$$$
$$$..............$$$
$..............$$$$$
$$$......$$$$$$$$$$$
